Давыдов Дмитрий Маркович	o@outlook.com	Subscribed
Сорокин Артемий Константинович	kaft93x@outlook.com	NotSubscribed
Овчинникова Алиса Фёдоровна	dcu@yandex.ru	Subscribed
Волкова Софья Ильинична	19dn@outlook.com	NotSubscribed
Калмыков Дмитрий Даниилович	pa5h@mail.ru	Subscribed
Данилов Демид Владиславович	281av0@gmail.com	Subscribed
Суворова Анна Арсентьевна	8edmfh@outlook.com	Subscribed
Николаева Анастасия Ивановна	sfn13i@mail.ru	NotSubscribed
Фирсова Александра Арсентьевна	g0orc3x1@outlook.com	Subscribed
Антонов Марк Дамирович	rv7bp@gmail.com	Subscribed
Постникова София Мироновна	93@outlook.com	Subscribed
Фомина Татьяна Ивановна	er@gmail.com	NotSubscribed
Лебедева Милана Тимофеевна	o0my@gmail.com	NotSubscribed
Шишкина София Мироновна	715qy08@gmail.com	Subscribed
Тихонова Есения Александровна	vubx0t@mail.ru	Subscribed
Соловьева Элина Григорьевна	wnhborq@outlook.com	Subscribed
Ефимов Роман Максимович	gq@yandex.ru	Subscribed
Захарова Агния Егоровна	ic0pu@outlook.com	NotSubscribed
Яковлев Дмитрий Андреевич	o7khr@yandex.ru	Subscribed
Никонов Илья Михайлович	2shlaq@outlook.com	NotSubscribed
